0 0 0 0 0 0 0 0 0 0 0 0 0 0 0 0 0 0 0 
0 2 1 1 1 1 1 1 1 0 1 1 1 1 1 1 1 2 0 
0 1 0 0 1 0 0 0 1 0 1 0 0 0 1 0 0 1 0 
0 1 1 1 1 1 1 1 1 1 1 1 1 1 1 1 1 1 0 
0 1 0 0 1 0 1 0 0 0 0 0 1 0 1 0 0 1 0 
0 1 1 1 1 0 1 1 1 1 1 1 1 0 1 1 1 1 0 
0 0 0 0 1 0 0 0 0 1 0 0 0 0 1 0 0 0 0 
8 8 8 0 1 0 1 1 1 1 1 1 1 0 1 0 8 8 8 
0 0 0 0 1 0 1 0 0 7 0 0 1 0 1 0 0 0 0 
1 1 1 1 1 1 1 1 4 5 6 1 1 1 1 1 1 1 1 
0 0 0 0 1 0 1 0 0 0 0 0 1 0 1 0 0 0 0 
8 8 8 0 1 0 1 1 1 1 1 1 1 0 1 0 8 8 8 
0 0 0 0 1 0 1 0 0 0 0 0 1 0 1 0 0 0 0 
0 1 1 1 1 1 1 1 1 0 1 1 1 1 1 1 1 1 0 
0 1 0 0 1 0 0 0 1 0 1 0 0 0 1 0 0 1 0 
0 1 1 0 1 1 1 1 1 3 1 1 1 1 1 0 1 1 0 
0 0 1 0 1 0 1 0 0 0 0 0 1 0 1 0 1 0 0 
0 1 1 1 1 0 1 1 1 0 1 1 1 0 1 1 1 1 0 
0 1 0 0 0 0 0 0 1 0 1 0 0 0 0 0 0 1 0 
0 2 1 1 1 1 1 1 1 1 1 1 1 1 1 1 1 2 0 
0 0 0 0 0 0 0 0 0 0 0 0 0 0 0 0 0 0 0 


//0 = Wall
//1  = food
//2 = superfood
//3 = pacman
//4 = blueGhost
//5 = pinkGhost
//6 = OrangeGhost
//7 = redGhost
//8 = skip
