XXXXXXXXXXXXXXXXXXX,
XF       X       FX,
X XX XXX X XXX XX X,
X                 X,
X XX X XXXXX X XX X,
X    X       X    X,
XXXX XXXX XXXX XXXX,
OOOX X       X XOOO,
XXXX X XXrXX X XXXX,
        bpo        ,
XXXX X XXXXX X XXXX,
OOOX X       X XOOO,
XXXX X XXXXX X XXXX,
X        X        X,
X XX XXX X XXX XX X,
X  X     P     X  X,
XX X X XXXXX X X XX,
X    X   X   X    X,
X XXXXXX X XXXXXX X,
XF               FX,
XXXXXXXXXXXXXXXXXXX

/*
O = skip,
X = Wall,
' ' = food,
F = superFood,
r = redGhost,
b = blueGhost,
p = pinkGhost,
o = orangeGhost,
P = Pacman,
*/